11 13
1 1
WWWWWWWWWWWWW
WE    W     W
W WWW W WWW W
W W       W W
W WWWWWWW WWW
W   W   W   W
WWW W WWW   W
W     W   W W
W WWWWW W WWW
W     W W
WWWWWWWWWWWWW