7 7
1 3
WWWWWWW
WEW WWW
W W WWW
W     W
WWW WWW
WWW WWW
WWWWWWW